2222222222
2111111112
2122222212
212    212
2122222212
2111111112